2 13 31
2222222222222222222222222222222
2400000330300303020300303030002
2020202320202323202020232323202
2005300000333003003005302030302
2020202020232020232320202020232
270000M000050330030030003600002
2020202020202020202320232020202
230030000000003K000003000100002
2020202023202020232320202020202
230K003300000@00003000007000002
2023202020202020232020202020202
2000006000003000300300300000002
2222222222222222222222222222222