3 13 31
2222222222222222222222222222222
2400000330300303020300303030002
2020202320202323202020232323202
2005300000333003003000302030302
2020202020232020232320202020232
2700000000050330030030003600002
2020202020202020202320232020202
230030000003003000M000000000002
2020202023202020232320202020202
2300003300300000003000M00000002
2023202020202020232020202020202
200000M000003000300300300000012
2222222222222222222222222222222