1 13 31
2222222222222222222222222222222
2400000330300103020300303030002
2020202320202323202020232323202
2005300000333003001000302030302
2020202020232020232320202020232
270000#000050330030030001600002
2020202020202020202320232020202
230030000003003000*003000000002
2020202023202020232320202020202
230#003300300@00003000000000002
2023202020202020232020202020202
2000000000003000300300000000002
2222222222222222222222222222222